aj3zfzrtbNA	Grape flavor can be spooky
C02GCe5_bDk	Global Citizen VAX Live - Extended Concert Only on YouTube
fCF8I_X1qKI	Elon Musk Monologue - SNL
zFpBqUyNM6E	Manchester City v. Chelsea | PREMIER LEAGUE HIGHLIGHTS | 5/08/2021 | NBC Sports
1SMyhrBv84c	Tiger spotted on front lawn of home in Fleetwood neighborhood
7o9mRta9ZkQ	Chinese rocket debris falls over Indian Ocean
B7rEumrxNW8	Building an Outdoor Kitchen in 72 Hours
CCwvODA3qek	Patti LaBelle, Gladys Knight, Johnny Gill & More Join DJ Cassidy To Perform Classics! | Pass The Mic
FuaDWyCnJxs	Chad on Mars - SNL
jrTXBFcvoMQ	Wario - SNL
ml7bK1jg69I	we like watching birds
pe33iZFfKm8	FAKE or REAL Injury? Canelo Alvarez vs Billy Joe Saunders - Doctor Explains What REALLY Happened
PEe-ZeVbTLo	Baelin's Route - An Epic NPC Man Adventure
q710Qe-0OOY	How Often You Should Shower And Wash Hair | Responding To Comments Ep. 22
RbuzojxNE3U	St. Johns County Sheriff's Office announces arrest of 14-year-old boy in death of 13-year-old girl
fFHfbH8UrFE	Character Teaser - "Eula: Midnight Encounter at the Tavern" | Genshin Impact
fYFIDHl9PdI	The Creative Summer Callout is Here - Fortnite Creative
NmwIdGUb3qY	We Bought 3 Cheap Ferraris For The Price Of A Toyota Camry - Car Trek S4E1
sS6ksY8xWCY	The Green Knight | Official Trailer HD | A24
uzkD5SeuwzM	TRUE Limits Of Humanity â€“ The Final Border We Will Never Cross
AAfsZtSFwwg	Machine Gun Kelly and Megan Fox's Second Date Was Swimming with Sharks in Bora Bora
O5WgT3jtUCI	The Champions: Season 5, Episode 3
rdKTjPDcTM0	This is one of the world's blackest paints
y_yBEDDSDpI	Houston police still looking for tiger and owner who was out on bond on a 2017 murder charge
y7AJnDRuemA	Olivia Rodrigo - drivers license (Live From The BRIT Awards 2021)
